NO ./path_to_the_north_texture
SO ./path_to_the_south_texture
WE ./path_to_the_west_texture
EA ./path_to_the_east_texture

F 220,100,0
C 225,30,0


1111111111111111111111111
1000000000110000000000001
1011000001110001000000001111111111
1001000000000000000001111111111111
1111111110110000011100000000000011
1000000000110000011101111111111111
11110111111111011100000010001
11110111111111011101010010001
11000000110101011100000010001
1000000000000000110000001000111
100000000000000011010100N010001
1100000111010101111101111000111    
11110111 1110101 101111010011
11111111 1111111 111111111111111111





