SO textures/wall1.xpm
EA textures/wall2.xpm
WE textures/wall3.xpm
NO textures/wall4.xpm

C 70,70,71
F 60,12,7

11111111111111111111
11111111110000000111
11111111111101111111
11111100000001111111
10000000000000000111
1000000000000000000111
1000000000010001111011
1000000000000000000111
1000000000000N000001
10000000000000111111
1111111111111111