NO textures/wall.xpm
EA textures/door.xpm
C 75,75,75
WE textures/wall.xpm
SO textures/wall.xpm

F 50,50,50


111111111111111111111111111111111        1111111111111111111111111
100000000000000000110000000000001        1000000000110000000000001
100000111111111111110000000000001        1011000001110000000000001
100000010000000000000000000000001        1001000000000000000000001
111111111111111111111111100000001111111111000000000000000000000001111111111
  1111111111111111111000000010110000011100000000000011111111110000000011101
111000000000000000000000000000000000000000000000000000000000000000000000001
100000000000000000000000000000000000000000000000000000000000000001111111111
111101111111110111000000100011100001111111101110000001000101000101
1111011111111101110101001000111101111111111011101010010001010001011111111
1110001110000001101010111000000101011100010011010101110000001000101000101
1000000000000000110000001000000000000000000001100000010001010001011111111
100000000000000011010100100011000000000000000110101001000101000101
110000011101010111110111100011110000111110101111110111101111101111
11110111 1110101 10111101000111100111 1110101 10111101000101000101
11111111 1111111 11111111111111101111 1111111 11111111111111111111
111101111111110111000000100011100001111111101110000001000101000101
111101111111110111010100100011110111111111101110101001000101000101
110000000000000000000000101011100010011010101110000001000101000101
100000E00000000011000000100011000000000000000110000001000101000101
100000000000000011010100101011000000000000000110101001000101000101
110000011101010111110111100011110000111110101111110111101111101111
10110111 1110101 10111101000111100111 1110101 10111101000101001001
11111111 1111111 11111111111111111111 1111111 11111111111111111111

